1111111111111111111
111111P111111111111
1111110111111111111
1000C00000C000000C1
1001100000000000011
1C0010C00000C000001
1000C11001100000001
111111100111101C111
1111111001111E11111
1111111111111111111