1111111111111111111
111111P111111111111
1111111111111111111
1000C00000C000000C1
1000000000000000011
1C0000C00000C000001
1000C11111100000001
111111111111101C111
1111111111111E11111
1111111111111111111