111111
1P0001
1C0C01
100E01
111111
